3<_<_ _ _

_ _<_ _ _
        ^
_<_>_ _ _

5 _ _ _ _

_ _ _<_ 3