_ 3 _>_ _ 5 _
        #   ^
_ _ _ _ _ _ _
  ^
4 5 _>_ _ 2 7
      #
_ _ _ _ _ _ _
    #       #
2 6 _ _ _ 1 3
            ^
_ _ _ _ _ _ _

_ 2 _ _<_ 3<_